#########.
..........
#....###@.
#.###..###
#.........
.....#.#..
#.#....#..
#.######..
#..##.....
......###.
