..........
..........
...#.#....
...#.#....
....@.....
.#.....#..
..#...#...
...###....
..........
..........
