##########
@........#
########.#
#......#.#
#.####.#.#
#.#.##.#.#
#.#....#.#
#.######.#
#........#
##########
